{
	"width": 26,
	"height": 18,
	"scale": 25,
	
	"layout": [ "....D..........D..........",
				"..........................",
				"..........................",
				"R.........................",
				".........................L",
				"..........................",
				"..........................",
				"..........................",
				"..........................",
				"..........................",
				"..........................",
				"..........................",
				"..........................",
				"..........................",
				"..........................",
				"..........................",
				"..........................",
				".U.................U......" ]
}
