{
	"width": 12,
	"height":12,
	"scale": 50,
	
	"layout": [ [".",".",".","D",".",".",".",".","D",".",".","."],
		        	[".",".",".",".",".",".",".",".",".",".",".","L"],
		    	    [".",".",".",".",".",".",".",".",".",".",".","."],
	    	      [".",".",".",".",".",".",".",".",".",".",".","."],
	      	    [".",".",".",".",".",".",".",".",".",".",".","."],
	      	    ["R",".",".",".",".",".",".",".",".",".",".","."],
	      	    [".",".",".",".",".",".",".",".",".",".",".","."],
	      	    [".",".",".",".",".",".",".",".",".",".",".","."],
	      	    [".",".",".",".",".",".",".",".",".",".",".","L"],
	      	    [".",".",".",".",".",".",".",".",".",".",".","."],
	      	    [".",".",".",".",".",".",".",".",".",".",".","."],
	      	    [".","U",".",".",".",".",".",".",".","U",".","."] ]
}
